#################################################
#                        #           #         <=3
#         #              #     I     ###        #
#         #              #     #       #    I   #
<=        #              I     #       #       <=1
#         #              I     #            I   #
#                        I     #                #
#                              #               <=2
#################################################  